7 10
|--------|
|FFF|....|
|........|
|FF...@|.|
|..F...|.|
|..F...|P|
|--------|